0,0,0,0,0,0,0,0,0,0,0,0,0,0,0,0,0,0,0,0,0,0,0,0,0,0,0,0,0,0,0,0
0,0,0,0,0,3,9,4,0,0,0,0,0,0,0,0,0,0,0,0,0,0,0,0,0,0,0,0,0,0,0,0
0,0,0,0,0,8,5,5,9,4,0,0,0,0,0,0,0,0,0,0,0,0,0,0,0,0,0,0,0,0,0,0
0,0,0,3,9,5,5,7,7,2,0,0,0,0,0,0,0,0,0,0,0,0,0,0,0,0,0,0,0,0,0,0
0,0,3,5,5,5,2,0,0,0,0,0,0,0,0,0,0,0,0,0,0,3,9,9,9,4,0,0,0,0,0,0
0,0,8,5,5,2,0,0,0,0,0,0,0,0,0,0,0,0,0,3,9,5,5,5,5,5,9,4,0,0,0,0
0,0,1,7,2,0,0,0,0,0,0,0,0,0,0,0,0,0,3,5,5,5,5,5,5,5,5,5,4,0,0,0
0,0,0,0,0,0,0,0,0,0,0,0,0,0,0,0,0,0,8,5,5,5,5,7,7,5,5,5,5,9,4,0
0,0,0,0,0,0,0,0,0,0,0,0,3,9,4,0,0,0,8,5,2,1,2,0,0,1,7,7,7,7,2,0
0,0,0,0,0,0,0,0,0,0,0,0,8,5,6,0,0,0,1,2,0,0,0,0,0,0,0,0,0,0,0,0
0,0,0,0,0,0,0,0,0,0,0,3,5,7,2,0,0,0,0,0,0,0,0,0,0,0,0,0,0,0,0,0
0,0,0,0,0,0,0,0,0,0,0,1,2,0,0,0,0,0,0,0,0,0,0,0,0,0,0,0,0,0,0,0
0,0,0,0,0,0,3,4,0,0,0,0,0,0,0,0,0,0,0,0,0,0,0,0,0,0,0,0,0,0,0,0
0,0,0,0,0,0,8,6,0,0,0,0,0,0,0,0,0,0,0,0,0,0,0,0,0,0,0,0,0,0,0,0
0,0,0,0,3,9,5,6,0,0,0,0,0,0,0,0,0,0,0,0,0,0,0,0,0,0,0,3,9,4,0,0
0,0,0,3,5,5,5,2,0,0,0,0,0,0,0,0,0,0,0,0,0,0,0,0,0,0,0,8,5,6,0,0
0,0,0,8,5,5,2,0,0,0,0,0,0,0,0,0,0,0,0,0,0,0,0,0,0,0,3,5,5,6,0,0
0,0,0,1,7,2,0,0,0,0,0,0,0,0,0,0,0,0,0,0,0,0,3,9,9,9,5,5,5,5,4,0
0,0,0,0,0,0,0,0,0,0,0,0,0,0,0,0,0,0,0,0,0,0,8,5,5,5,5,5,5,5,5,9
0,0,0,0,0,0,0,0,0,0,0,0,0,0,0,0,0,0,0,0,0,3,5,5,5,5,5,5,5,5,5,5
0,0,0,0,0,0,0,0,0,0,0,0,0,0,0,0,0,0,0,3,9,5,2,1,5,5,5,5,5,5,7,5
0,0,0,0,0,0,0,3,9,9,9,4,0,0,0,0,0,0,0,1,7,2,0,0,1,7,5,5,5,2,0,1
0,0,0,0,0,3,9,5,5,5,5,5,9,4,0,0,0,0,0,0,0,0,0,0,0,0,1,7,2,0,0,0
0,0,0,0,3,5,5,5,5,5,5,5,5,5,4,0,0,0,0,0,0,0,0,0,0,0,0,0,0,0,0,0
0,0,0,0,8,5,5,5,5,7,7,5,5,5,5,9,4,0,0,0,0,0,0,0,0,0,0,3,9,4,0,0
0,0,0,0,8,5,2,1,2,0,0,1,7,7,7,7,2,0,3,4,0,0,0,0,0,3,9,5,5,6,0,0
0,0,0,0,8,6,0,0,0,0,0,0,0,0,0,0,0,0,8,6,0,0,0,0,0,8,5,5,5,6,0,0
0,0,0,3,5,2,0,0,0,0,0,0,0,0,0,0,0,0,8,5,4,0,0,0,0,1,5,5,5,2,0,0
0,0,0,1,2,0,0,0,0,0,0,0,0,0,0,0,0,0,1,7,5,9,9,9,4,0,1,7,2,0,0,0
0,0,0,0,0,0,0,0,0,0,0,0,0,0,0,0,0,0,0,0,1,2,1,5,6,0,0,0,0,0,0,0
0,0,0,0,0,0,0,0,0,0,0,0,0,0,0,0,0,0,0,0,0,0,0,8,2,0,0,0,0,0,0,0
0,0,0,0,0,0,0,0,0,0,0,0,0,0,0,0,0,0,0,0,0,3,9,6,0,0,0,0,0,0,0,0
